0,0,0,0,0,0,0,0,0,0
0,0,0,0,0,0,0,0,Y,0
0,1,1,1,1,0,0,0,0,0
0,1,1,1,1,2,0,0,0,0
0,0,0,0,2,2,2,0,0,0
0,0,0,0,0,2,0,0,0,0
0,0,0,0,0,0,0,0,0,0
0,0,0,P,0,P,0,0,0,0
0,X,0,0,P,0,P,0,0,0
0,0,0,0,0,0,0,0,0,0