R,1,1,2,1,1,1,2,1,1,R
1,R,1,2,1,1,1,2,1,R,1
1,1,1,2,1,2,1,2,1,1,1
1,2,0,2,1,2,1,2,0,2,1
P,2,0,0,1,2,1,0,0,2,P
R,2,0,X,1,2,1,Y,0,2,R
P,2,0,0,1,2,1,0,0,2,P
1,2,0,2,1,2,1,2,0,2,1
1,1,1,2,1,2,1,2,1,1,1
1,H,1,2,1,1,1,2,1,H,1
H,1,1,2,1,1,1,2,1,1,H