0,1,0,1,0,0,0,1,1,1,1
R,1,R,1,0,0,0,1,1,1,1
2,2,2,2,0,0,0,2,0,0,0
P,1,1,0,0,0,0,2,0,Y,0
H,1,1,0,1,1,1,2,0,0,0
2,2,2,2,1,2,1,2,2,2,2
0,0,0,2,1,1,1,0,1,1,P
0,X,0,2,0,0,0,0,1,1,H
0,0,0,2,0,0,0,2,2,2,2
1,1,1,1,0,0,0,1,R,1,R
1,1,1,1,0,0,0,1,0,1,0