0,0,0,0,0,P,0,0,0,0,0
1,1,1,1,1,2,1,1,1,1,1
1,1,H,1,1,2,1,1,R,1,1
1,1,1,1,1,2,1,1,1,1,1
0,0,0,0,0,2,0,0,0,0,0
0,2,2,0,X,2,Y,0,2,2,0
0,0,0,0,0,2,0,0,0,0,0
1,1,1,1,1,2,1,1,1,1,1
1,1,R,1,1,2,1,1,H,1,1
1,1,1,1,1,2,1,1,1,1,1
0,0,0,0,0,P,0,0,0,0,0