P,0,1,1,1,1,1,1,1,0,Y
0,0,0,0,1,2,1,0,0,0,0
1,1,1,1,1,2,1,1,1,1,1
1,1,H,1,1,1,1,1,P,1,1
1,1,1,1,1,2,1,1,1,1,1
1,1,1,1,R,2,R,1,1,1,1
1,1,0,0,2,H,2,0,0,1,1
1,0,1,1,0,0,0,1,1,0,1
1,0,2,0,1,1,1,0,2,0,1
0,2,0,0,1,P,1,0,0,2,0
X,0,1,1,1,1,1,1,1,0,1