R,1,1,1,0,0,2,0,0,0,0
1,2,1,1,1,0,2,1,0,Y,1
1,2,1,H,1,0,2,1,1,1,1
1,2,1,1,1,2,0,1,2,2,2
0,0,2,1,1,1,1,0,1,0,0
0,0,1,2,2,P,2,2,1,0,0
0,0,1,0,1,1,1,1,2,0,0
2,2,2,1,0,2,1,1,1,2,1
1,1,1,1,2,0,1,H,1,2,1
1,X,0,1,2,0,1,1,1,2,1
0,0,0,0,2,0,0,1,1,1,R