0,0,0,1,1,1,1,1,1,R,R
1,0,0,2,2,2,2,2,2,2,R
1,1,0,0,1,0,1,1,H,2,1
R,1,1,0,1,1,1,2,1,2,1
1,1,0,0,1,2,H,1,1,2,1
1,0,0,2,1,2,2,1,0,2,1
X,0,2,1,0,1,1,1,1,2,1
0,2,1,0,1,2,0,0,0,2,1
2,1,P,1,2,0,0,1,0,0,0
1,0,1,2,0,0,1,1,1,0,0
P,1,2,0,Y,1,1,R,1,1,0