1,1,1,1,1,1,1,1,1,1,1
1,2,1,2,2,R,2,2,1,2,1
1,1,2,1,1,1,1,1,2,1,1
1,2,1,2,1,R,1,2,1,2,1
0,2,1,1,1,2,1,1,1,2,0
X,P,1,H,2,2,2,H,1,P,Y
0,2,1,1,1,2,1,1,1,2,0
1,2,1,2,1,R,1,2,1,2,1
1,1,2,1,1,1,1,1,2,1,1
1,2,1,2,2,R,2,2,1,2,1
1,1,1,1,1,1,1,1,1,1,1